######
.....#.####
.##..###..#
..........#
#...@..#..#
.....###..#
..#..#....#
.##....#.##
.........#
........#
.#######