...#
..##.#.####
.##..###..#
##........#
#...@..#..#
########..#
..#..#....#
.##.##.#.##
.#.#....##
.######
.#######