.#.###..##
..##.#.#..#
.##..#.#..#
##........#
#...@..#..#
####...#..#
..#..#....#
.##.##.#.##
.#......##
.#.....##
.##....#